ちっす	お世話になっております	名詞	
おまえ	御社	名詞	
おれ	弊社	名詞	
おい	お疲れ様です	名詞	
いきてるか	ご無沙汰しております	名詞	
うぃーす	お世話になります	名詞	
はいはい	承知いたしました	名詞	
おいてめえ	突然のメール失礼いたします	名詞	
なんだこれ	拝見いたしました	名詞	
しょーもねえもんおくってくんじゃねえよ	確かに受領いたしました	名詞	
だまっていうことをきけ	ご相談があります	名詞	
ごみかす	添付ファイル	名詞	
どうせひまなおまえのとくにひまなとき	ご都合のいい日時	名詞	
おれのねつきがよくなる	幸いです	名詞	
なんでこんなことしないといけないんだよ	返答が遅れまして、大変申し訳ございません	名詞	
きてないんだがふざけてんのか	届いておりませんので	名詞	
いつまでもたいようのしたをあるけるとおもうなよ	念のため確認のメールをさせていただきました	名詞	
しかとしてんじゃねえこのやろう	届いておりますでしょうか？	名詞	
さぼってるのはわかってるんだからないいかげんにしろよてめえ	進捗はいかがでしょうか	名詞	
どうせひまなんだからそのぶさいくなつらあらってからさっさとへんじしろうすのろ	ご多忙のところ恐れ入りますが、至急ご返信いただければ幸いです	名詞	
できるわけないだろじょうしきないのかおまえ	ご期待に沿えずに申し訳ございません	名詞	
だれでもできることわざわざたのむなあほ	お引き受けいたします	名詞	
いちいちうるせえやつだな	ご連絡ありがとうございます	名詞	
よみちにはせいぜいきをつけろよ	大変申し訳ございません	名詞	
さっさとおわらせてくれ	どうぞよろしくお願いたします	名詞	
たりないあたまつかってよーくかんがえろ	ご検討のほど、よろしくお願い申し上げます	名詞	
めのまえのはこでしらべろぼけ	ご不明な点がありましたら、お問い合わせください	名詞	
くたばれ	取り急ぎ、ご連絡まで	名詞	
もうおまえとはいっさいかかわりたくない	なお、ご返信は不要です	名詞	
このやろう	様	名詞	
ちーっす	いつもお世話になっております	名詞	
きさまになのるななどない	株式会社△△の○○です	名詞	
かみくず	ご請求書	名詞	
めんどくさいけどれんらくしてやるぞ	ご連絡です	名詞	
どうせおまえにはきたいしてないが	恐れ入りますが	名詞	
よこさなかったらどうなるかかくごしておけ	送付いただけますでしょうか	名詞	
しんでわびろ	なお、本メールと行き違いになっている場合はなにとぞご容赦ください。	名詞	
あばよ	それでは今後ともよろしくお願いいたします。	名詞	
かえりたい	精一杯努力させていただきます	名詞	
きえてなくなりたい	今後ともご指導ご鞭撻を賜りますようお願い申し上げます。	名詞	
やるきがない	より一層皆様にご満足いただけますよう、全力を尽くす覚悟でございます。	名詞	
すべてなげだしてみなみのしまでねそべりながらじゅーすのみたい	使命を果たすべく、業務に邁進する所存です	名詞	
おまえみたいなのとであってしまったうんめいをのろう	今後とも末永いお取引をいただきますよう、謹んでお願い申し上げます	名詞	
やだ	承服いたしかねます	名詞	
なんでそんなことせんといかんのよ	ありがたいお申し入れながら、お受けすることができません	名詞	
くだらねえおまえにふさわしいごみをおとどけするぜ	なにとぞご笑納くださいますようお願い申し上げます。	名詞	
こい	ご多忙中のところ恐縮ですが、ぜひともご参加くださいますようお願い申し上げます。	名詞	
くっせえくちからくっせえいきはいてるんだろうな	ますますご盛栄のこととお慶び申し上げます	名詞	
てぬきします	お役に立てれば幸いです	名詞	
すぐへんじしろよ	折り返しのお返事をお待ちしております。	名詞	